00XXX000
00XHX000
00XCXXXX
XXXCCCHX
XHCCCXXX
XXXXCX00
000XHX00
000XXX00