00XXXXXX
00XCCCCX
XXXCCCCX
XCCCHHCX
XCCHHHXX
XXXXCCX0
000XXXX0