XXXXX0000
XCCCX0000
XCCCX0XXX
XCCCX0XHX
XXXCXXXHX
0XXCCCCHX
0XCCCXCCX
0XCCCXXXX
0XXXXX000