0XXXXXXX00
0XCCCCCXXX
XXCXXXCCCX
XCCCCCCCCX
XCHHXCCCXX
XXHHXCCCX0
0XXXXXXXX0