0XXXX0
XXCCX0
XCCCX0
XXCCXX
XXCCCX
XHCCCX
XHHHHX
XXXXXX