0XXXXX00
0XCCXXX0
0XCCCCX0
XXXCXCXX
XHXCXCCX
XHCCCXCX
XHCCCCCX
XXXXXXXX