000XXXXXXX000
XXXXCCCCCX000
XCCCHXXXCX000
XCXCXCCCCXX00
XCXCCCCXHCX00
XCXCCHCCXCX00
XCHXCCCCXCX00
XXCCCCXCXCXXX
0XCXXXHCCCCCX
0XCCCCCXXCCCX
0XXXXXXXXXXXX