000XXXXXXX
00XXCCXCCX
00XCCCXCCX
00XCCCCCCX
00XCCXXCCX
XXXCCCXCXX
XHHHHHCCX0
XXXXXXXXX0