000XXXXXX0
0XXXCCCCX0
XXHCCXXCXX
XHHCCCCCCX
XHHCCCCCXX
XXXXXXCCX0
00000XXXX0