0XXXXXXXXX0
0XCCXXCCCX0
0XCCCCCCCX0
0XCCXXXCCX0
0XCXHHHXCX0
XXCXHHHXCXX
XCCCCCCCCCX
XCCCCCXCCCX
XXXXXXXXXXX